<map>
00000000000000000000000000000000000000000000000000000000000000000000000000000000000000000000000000000000000000000000000000000000000000000000000000000000000000000000000000000000000000000000000000000000000000000000000000000101010101010101010100010101010101010001010101010101010100000000000000000000000000000000000000000000000000000000000000000000000000
00000000000000000000000000000000000000000000000000000000000000000000000000000000000000000000000000000000000000000404040000000000000000000000000000000000000000000000000000000000000000000000000000000000000000000000000000000111111111111111110100011111111111010001111111111111110100000000000000000000000000000000000000000000000000000000000000000000000000
00000000000000000000000000000000000000000000000000000000000000000000000000000000000001010100000001010100000000000101010000000000010101000000000000000000000000000000000000000000000000000000000000000000000000000000000000000111111111111111110100011111111111010001111111111111110100000000000000000000000000000000000000000000000000000000000000000000000000
00000000000000000000000000000000000000000000000000000000000000000000000000000000000001000101010101000100000000000100010101010101010001000000000000000000000001100100000000000000000000000000000000000000000000000000000000000111111111111111110100011111111111010001111111111111110100000000000000000000000000000000000000000000000000000000000000000000000000
00000000000000000000000000020000000000000000000000000000000000000000000000000000000001010100000001010100000000001401010000000000010101000000000000000000000001000101010100000000000000000003000000000000000000000001010101000111111111010101010100010101010101010001010101010101010100000000000000000000000000000000000000000000000000040000000000000000000000
00000000000000000000000000000000000000000000000000000000000000000000000000000000000000010000000000010000000000000000000000000000000000000000000000000000000001010100000100000000000000000101010000000000010101010001111101000111111111010000000000000000000000000000000000000000000000000000000000000000000000000000000400000000000000010000000000000000000000
00000000000000000000000000000000000000000000000000000000000000000000000000000000000000010000000000010000000000000000000000000000000000000000000000000000000000010000000100000000000000000100010101010101011111010001111101000111111111010001010101010100010101010101010000000000000000000000000000000004000000000000000100000000000000010000000000000000000000
01010000000000000000000000000000000000000001011400000000001201010000000000011001000000010000000000010000000000000000000000000000000000000000000000000000000000010000000100000000000000000101010000000000011111010001111101000111111111010001111111110100011111111111010000000000000000000101010101010101010101010101010101010101010101010000000000000000000000
00010101010101010101010101010101010101010101000100000000000100010101010101010001010101010000000000010000000000000000000000000000000000000000000000000000000000010000000100000000000000000001000000000000011111010001010101000101010111010001111111110100011111111111010000000000000000000100000000000000000000000000000000000000000000000000000000000000000000
01010000000000000000000000000000000000000001010100000000000101010000000000010101000000000000000001010100000000001201010000000000010101000000000001100100000000010000000100000000000000000001000000000000011111010000000000000000000111010001111111110100011111111111010000000000000000000100000000000000000000000000000000000000000000000001111111111111111101
00000000000000000000000000000000000000000000000000000900000000000000000000000000000000000000000001000100000000000100010101010101010001010101010101000101010101010000000100000000000000000001000000000000011111010101010101010101000111010001111111110100011111111111010000000101010101010100000000000000000000000000000000000000000000000000000000000000000000
00000000000000000000000000000000000000000000000000000000000000000000000000000000000000000000000001010100000000000101010000000000010101000000000001010100000000000000000100000001100100000001000000000000011111111111111111111101000101010001010101010100010101010101010000000100000000000000000000000000000000000000000000000000000000000000000000000000000000
00000000000000000000000000000000000000000000000000000000000000000000000000000000000000000000000000000000000000000000000000000000000000000000000000000000000000000000000101010101000101010101000000000000011111111111111111111101000000000000000000000000000000000000000000000100000000000000000000000000000000000000000000000000000000000000000000000000000000
00000000000000000000000000000000000000000000000000000000000000000000000000000000000000000000000000000000000000000000000000000000000000000000000000000000000000000000000000000001010100000000000000000000010101010101010101010101010101010101010101010101010101010101010101010100000000000000000000000000000000000000000000000000000000000000000000000000000000
</map>
<tip>
I have taught you everything I know.
</tip>