<map>
0000000000000000000000000000000000000000000000000001010000000000000000000000000000000000000000000000000101010000000000000000000000000000000001010101000000000000000000000000000000000000000000000000000000000000000000000000000000000000000000000000000404040000000000000000000000000000000000000000000000000000000000000000000000000000000001010101010101010000000000000000000000000000010101000000000000000000000101010101010100010101010100000000000000000000000000000000000000000000000000000000000000010101010101010101000000000000000000000000000000000000000000000000000000000000000000000000000000000000000000000000000000000000000000000000000000000000000000000000000000000000000000000000000000000000000000000000000000000000000000000000000000000000000000000000000000000000000000
0000000000000000000000000000000000000000000000000101010101010000000000000000000000000000000000000000000101010100000000000000000000000000000001010101010101010100000000000000000000000000000000000000000000000000000000000000000000000000000000000404040101010000000000000000000000000000000000000000000000000000000000000000000000000000000101010101010101010101010000000000000000000101010101010101000000000000010101010101010101010101010101010101000000000000000000000000000000000000000000000000000101010101010101010101010101000000000000000000000000000000000000000000000000000000000000000000000000000004000000000000000000000000000000000000000000000000000000000000000000000000000000000000000000000000000000000000000000000000000000000000000000000000000000000000000000000000000000
0000000000000000000000000000000000000000000000000101010101010101000000000000000000000000000000000000000101010100000000000000000000000101010101010101010101010101000000000000000000000000000000000000000000000000000000000000000000000000000000040101010101010000000000000000000000000000000000000000000000000000000000000000000000000000000101000000000000000001010101000000000101010100000000010101010001010101010000000000000000000000000000000101010101000000000000000000000000010101010101010101010101010000000000000001010101010100000000000000000000000000000000000000000000000000000000000000000001010101010101010000000000000000000000000000000000000000000000000000000000000000000000000000000000000000000101010100000000000000000000000000000000000000000000000000000000000000000000
0000000000000000000000000000000000000000000000000101010101010101000000000000000000010100000000000000000001010000000000000000000000000101010101010101010101010101010100000000000000000000000000000000000000000000000000000000000000000000000004010101010101010000000000000000000000000000000000000000000000000000000000000000000000000000000000000000000000000000000101010101010101010000000000000000010101010101010000000000000000000000000000000000000001010101010000000000010101010101010000000000000000000000000000000000000000000101000000000000000000000000000000000000000000000000000000000000000101010101010101010100000000000000000000000000000000000000000000000000000000000000000000000000000000000000010101010100000000000000000000000000000000000000000000000000000000000000000000
0000000000000000000000000000000000000001010000000101010101010100000000000000000000010101000000000000000000000000000000000000010101010101010101010101010101010101010101000000000000000000000000000000000000000000000000000000000000000000000001010101010100000000000000000000000000000000000000000000000000000000000000000000000000000000000000000000000000000000000001010000000000000000000000000000000000010000000000000000000000000000000000000000000000010001010100000101010101010000000000000000000000000000000000000000000000000101010100000000000000000000000000000000000000000000000400000000000101010101010101010100000000000000000000000000000000000000000000000000000000000000000000000000000000000001010101010000000000000000000000000101010104000000000000000000000000000000000000
0000000000000000000000000000000001010101010000000001000000000000000000000000000000000101010100000000000000000000000000000000010101010101000000000001010101010101010101000000000000000000000000000000000000000000000000000000000000000000000001010101010100000000000000000000000000000000000101000000000000000000000101010100000000000000000000000000000000000000000001010000000000000000000000000000000000010000000000000000000000000000000000000000000000010000000101010101000000000000000000000000000000000000000001000000000000000000010101010000000000000000000000000000000000000101010101010000000001010101010101010000000001010104000000000000000000000000010101040000000000000000000000000101010400000001010101000000000000000000000000010101010101000000000000000000000000000000000000
0000000000000000000000000000000001010101000000000000000000000000000001010101000000000101010101010000000000000000000000000000010101010000000001010101010101010101010100000000000000000000000000000000000000000000000000000000000101010000000001010101000000000000000000000000000000000000010101010000000400000000000101010101000000000000000000000000000000000000000001010000000000000000000000000000000000060000000000000000000000000100000000000000000000010000000000000000000000000000000000000000000100000000000000000000000000000000000101010100000000000000000004000000000000010101010101010100000000000101010100000000000101010101000000000000000000000001010101010000000000000000000000010101010100000101010101000000000001010100000000010101010101000000001111111111111111111111111111
0000000000000000000000000000000000010100000000000000000000000000000001010101000000000001010101010000000000000101010101000000000101010000000101010101010101010101000000000000000000000000000000000000000000000000000000000000010101010000000001010100000000000000000000000001010101000000010101010000000101010000000101010100000000000000000000000000000000000000000001010000000000000000000000000000000000000001010101000000000000000000000001010000000000060000000000000000000000010101010000000000000000000000000000000000000000000000000001010100000000000000010101010100000000010101010101010100000000000000000000000000000101010101000000000000000000000001010101010000000001010101040000010101010100000101010000000000010101010101000000000001010100000000000000000000000000000000000000
0000000000000101000000000101000000000000000000000000000000000000000000010101000000000000010101010101010100010101010101000000000000000000000101010101010101010101000000000000000000000000000000000000010101000000010101000000010101010100000006060600000000000000000000000101010101000000000101010000010101010100000000000000000000000000000000000000000000000000000006060000000004000000000000000000000000000001010101010101000000000000000001010000000000000000000000000000000000010101010000000000000000000000000000000000000000000000000000000000000000000001010101010101000000000001010101010000000000000000000000000000000101010100000000000101010400000001010101010000000101010101010000010101010100000000000000000000010101010101010000000000000000000000000000000000000000000000000000
0000000000000101010000000101000000000000000000000000000001010100000000000000000000000001010101010101010101010101010101000000000000000000000101010101000000000000000000000000000000000000000000000001010101000000010101010000000001010100000000000000000000000000000000000101010101000000000000000000010101010100000000000000000000000000000000000000000000000000000000000000000001000000000000000000000101010101010101010101010100000000000001010000000000000000000000000001010101010101010100000000000000000000000000000000000000000000010101010101010100000001010101010101010100000000000100000000000000000000000000000000000001010000000000010101010100000000000000000000010101010101010000000101010000000000000000000000000101010101000000000000000000000000000000000000000000000000000000
0000000000000001010000000000000000000000000000000000000001010100000000000000000000000001010101010101010101010101010101000000000000000000000001010101000000000000000000000000000000000000000000000001010100000001010101010000000000000000000000000000000000000101010100000101010100000000000000000000000101010000000000000000000000000101010000000000000000000001010101010000000001000000000000010101010101010101000000000101010101000000000006060000000000000000010101010101010101000101010101010101010000000000000000000000000000010101010101010101000000000000010101010101010000000000000000000000000000000000000000000000000000000000000000010101010000000000000000000000010101010101000000000000000000000000000000000000000101010000000000000000000000000000000000000000000000000000000000
0000000000000000000000000000000000000000000001010100000001010000000000000000000000000000010101000101010100000101010000000000000000000000000000010100000000000000000000000000000000000001010101000000000000000101010101010000000000000000000000000000000000000101010101000001010100000000000000000000000000000000000000000000000000000001010000000000000000000101010101010100000001000000010101010101000000000000000000000000000101010100000000000000000101010101010100000000000000000000000000000101010101040404040404040404040404010101010100000000000000000000000001010101000000000000000000000000000000000000000000000000000000000000000000010101000000000000000000000000000101010100000000000000000000000000000000000000000000000000000000000000000000000000000000000000000000000000000000
0000000000000000000000000000000000000000000001010100000000000000000000000000000000000000000000000000000000000000000000000000000000000000000000000000000000000000000000000000000000000101010101000000000000000001010101000000000000000000000000000001010101010101010101000000000000000000000000000000000000000000000000000000000000000001010100000404040000010100000000010101010101010101010101000000000000000000000000000000000001010101010100000101010101000000000000000000000000000000000000000000000001010101010101010101010101010100000000000000000000000000000000000000000000000000000000000000000000000000000000000000000000000000000000000000000000000000000000000000000000000000000000000000000000000000000000000000000000000000000000000000000000000000000000000000000000000000000000
0000000000000000000000000000000000000000000000010100000000000000000000000000000000000000000000000000000000000000000000000000000000000000000000000000000000000000000000000000000000000101000000000000000000000000000000000000000000000000000000000001010101010100000000000000000000000000000000000000000000000000000000000000000000000000000101010101010101010000000000000000010101010101000000000000000000000000000000000000000000000000010101010101010000000000000000000000000000000000000000000000000000000001010101010101010101000000000000000000000000000000000000000000000000000000000000000000000000000000000000000000000000000000000000000000000000000000000000000000000000000000000000000000000000000000000000000000000000000000000000000000000000000000000000000000000000000000000000
</map>
<tip>

</tip>